20 14
0 0 0 0 0 0 0 0 0 0 0 0 0 0 0 0 0 0 0 0
0 0 0 0 0 0 0 0 0 0 0 0 0 0 0 0 0 0 0 0
0 0 1 2 1 2 1 2 1 2 1 2 1 2 1 2 1 2 0 0
0 0 0 0 0 0 0 0 0 0 0 0 0 0 0 0 0 1 0 0
0 0 0 0 1 2 1 2 1 2 1 2 1 2 1 2 0 2 0 0
0 0 0 0 2 0 0 0 0 0 0 0 0 0 0 1 0 1 0 0
0 0 0 0 1 0 1 2 1 2 1 2 1 3 0 2 0 2 0 0
0 0 0 0 2 0 2 0 2 1 2 1 2 3 0 1 0 1 0 0
0 0 0 0 1 0 1 0 0 0 0 0 0 0 0 2 0 2 0 0
0 0 0 0 2 0 2 1 2 1 2 1 2 1 2 1 0 1 0 0
0 0 0 0 1 0 0 0 0 0 0 0 0 0 0 0 0 2 0 0
0 0 0 0 2 1 2 1 2 1 2 1 2 1 2 1 2 1 0 0
0 0 0 0 0 0 0 0 0 0 0 0 0 0 0 0 0 0 0 0
0 0 0 0 0 0 0 0 0 0 0 0 0 0 0 0 0 0 0 0