20 16
0 0 0 0 0 0 0 0 0 0 0 0 0 0 0 0 0 0 0 0
0 0 0 0 0 0 0 0 0 0 0 0 0 0 0 0 0 0 0 0
0 0 1 2 1 2 1 2 1 2 1 2 1 2 1 2 1 2 0 0
0 0 2 1 2 1 2 1 2 1 2 1 2 1 2 1 2 1 0 0
0 0 1 2 1 2 1 2 1 2 1 2 1 2 1 2 1 2 0 0
0 0 2 1 2 1 2 1 2 1 2 1 2 1 2 1 2 1 0 0
0 0 1 2 1 2 0 0 0 0 0 0 0 0 1 2 1 2 0 0
0 0 2 1 2 1 0 0 0 0 0 0 0 0 2 1 2 1 0 0
0 0 1 2 1 2 0 0 0 0 0 0 0 0 1 2 1 2 0 0
0 0 2 1 2 1 0 0 0 0 0 0 0 0 2 1 2 1 0 0
0 0 1 2 1 2 0 0 0 0 0 0 0 0 1 2 1 2 0 0
0 0 2 1 2 1 0 0 0 0 0 0 0 0 2 1 2 1 0 0
0 0 1 2 1 2 1 2 0 0 0 0 3 3 1 2 1 2 0 0
0 0 2 1 2 1 2 1 0 0 0 0 3 3 2 1 2 1 0 0
0 0 0 0 0 0 0 0 0 0 0 0 0 0 0 0 0 0 0 0
0 0 0 0 0 0 0 0 0 0 0 0 0 0 0 0 0 0 0 0